36
*********************************************************************************************
*             ********************                                                          *
*             ********************                                                          *
*             ********************                                                          *
*             ********************                                                          *
*             ********************                                                          *
*             ********************                                                          *
*             ********************                                                          *
*             ********************                         *                                *
*             ********************                         *                                *
*             ********************         ****            *                                *
*             ********************                         *                                *
*                                                                                           *
*                                    ****                                                   *
*                                                                                           *
*                                                                                           *
*                                                                                           *
*                **                                                                         *
*                                        ****         ****                                  *
*                                                      **                                   *
*                    *                                ****                                  *
*                    *                                                                      *
*                    *                                                                      *
*                    *                                               ****                   *
*                                                                    ****                   *
*                                    ****                                                   *
*            *                                                                              *
*                                                                                           *
*                                                                                           *
*                                                                                           *
*                                                                                           *
*                                                                                           *
*                                                                                           *
*                                                                                           *
*                                                                                           *
*********************************************************************************************